- saint: قديس
- icon: أيقونة
- cross: صليب
- liturgy: ليتورجيا (طقس ديني)
- bishop: أسقف
- priest: كاهن
- deacon: شماس
- monk: راهب
- nun: راهبة
- cathedral: كاتدرائية
- psalm: مزمور
- gospel: إنجيل
- apostle: رسول
- martyr: شهيد
- holy: مقدس
- baptism: معمودية
- chrismation: مسحة (طقس ديني)
- eucharist: الإفخارستيا (العشاء الرباني)
- orthodox: أرثوذكسي
- vespers: صلاة الغروب
- hymn: ترنيمة
- fasting: صوم
- pascha: الفصح (عيد القيامة)
- nativity: الميلاد (عيد الميلاد)
- trinity: الثالوث
- resurrection: القيامة
- ascension: الصعود
- pentecost: عيد العنصرة
- transfiguration: التجلي
- annunciation: البشارة
- theotokos: والدة الإله
- iconostasis: حاجز الأيقونات
- clergy: رجال الدين
- divine: إلهي
- sacrament: سر مقدس (سر من الأسرار المقدسة)

